1111111
10C0001
1P00001
100E001
1111111
