1111111
10C00N1
1P00001
100E001
1111111