111111111111111
1E00000C0000C01
1010N1010010101
101001001010101
1P0000C00C000C1
111111111111111