111111111111
1P00000000C1
101011101001
100000100NE1
1C0111010001
111111111111