111111111
1P0000N01
101010101
1C00C00E1
111111111